FE8 - Fields - 01000203
40 27
424 586 456 586 459 586 459 528 816 817 142 6 6 6 143 720 775 424 586 424 586 424 586 424 586 424 586
424 553 424 551 459 586 459 528 848 849 142 38 6 38 143 868 98 424 586 424 585 424 586 424 586 424 586
424 586 459 586 456 586 459 592 720 64 102 6 6 6 6 135 685 456 586 549 609 424 586 424 586 424 586
459 586 459 560 559 494 530 624 744 745 98 142 38 6 6 143 685 559 560 559 525 424 586 456 586 424 592
491 586 558 647 653 653 654 776 777 849 98 142 6 6 38 143 98 720 685 685 559 747 560 559 432 530 624
559 592 652 653 744 745 720 98 98 65 98 166 111 111 111 167 98 98 98 744 745 775 685 653 653 685 685
412 412 412 412 412 412 412 412 412 412 412 34 756 756 756 34 412 412 412 412 412 412 412 412 98 720 98
117 117 117 117 117 117 117 117 117 117 118 34 724 724 724 34 116 117 117 117 117 117 117 118 412 412 412
212 213 212 213 212 213 212 213 212 212 213 34 724 724 724 34 212 212 212 213 212 213 212 213 52 117 117
213 245 244 245 244 245 244 245 213 244 245 34 724 724 724 34 244 244 213 245 244 245 244 212 212 213 213
84 87 85 86 85 84 85 87 85 84 84 34 724 724 724 34 84 87 85 85 84 85 86 244 213 245 245
444 444 444 444 444 444 444 444 444 444 444 34 788 788 788 34 444 444 784 785 444 444 444 23 84 85 84
71 14 98 66 98 784 785 98 66 98 74 78 75 98 74 78 75 66 98 98 98 98 98 444 444 444 444
143 42 880 882 98 98 14 66 98 98 174 868 175 98 174 868 175 98 880 881 881 882 98 98 14 98 134
143 42 912 913 882 98 42 98 720 98 106 110 107 98 106 110 107 14 912 913 913 946 98 98 42 98 142
103 46 912 913 913 98 46 98 66 98 98 98 98 783 98 98 98 42 944 913 914 64 98 98 42 98 142
881 881 913 913 913 98 98 98 66 720 783 720 98 98 782 66 98 46 65 912 946 782 98 98 46 98 166
721 723 913 913 913 881 882 98 98 66 98 784 785 98 98 98 98 98 880 946 64 98 66 98 98 784 785
721 722 723 913 913 913 913 881 882 98 66 98 66 98 880 881 881 881 914 64 98 98 98 98 66 98 98
818 818 913 945 945 945 913 913 913 881 881 881 850 850 913 913 945 945 913 881 881 882 98 880 881 881 881
913 914 946 810 811 812 64 65 944 945 913 913 64 65 944 946 64 65 944 945 945 913 881 913 913 913 913
913 914 64 842 843 844 129 66 64 65 944 913 881 882 64 64 66 98 64 64 65 912 913 913 913 913 753
913 914 836 64 874 720 66 804 66 931 65 913 913 913 881 881 850 850 881 881 881 913 913 913 913 721 722
945 946 900 98 98 98 98 875 98 875 880 913 913 913 913 946 64 65 913 913 945 913 913 913 913 753 754
275 98 875 720 66 804 66 98 880 850 946 64 64 65 945 64 98 880 913 946 65 944 945 913 721 722 723
307 98 66 66 98 875 98 880 913 64 64 66 74 868 64 98 880 913 946 64 98 64 65 912 753 754 755
881 881 881 881 881 881 881 913 913 98 66 899 106 107 98 880 913 946 64 899 816 817 66 912 912 721 722
913 913 913 913 913 945 913 913 913 850 882 98 66 98 880 946 64 64 140 141 848 849 98 912 944 753 721
913 913 913 945 946 65 912 913 914 65 944 850 881 881 914 64 66 98 172 173 64 64 98 944 945 946 753
913 913 914 64 804 66 912 913 914 98 64 65 912 913 945 881 881 881 881 881 881 881 882 65 912 913 913
913 913 914 33 875 66 912 913 914 98 880 881 913 946 65 944 945 945 945 945 945 945 913 881 913 913 913
721 721 722 723 881 881 913 913 913 850 913 946 64 64 98 64 64 64 720 64 64 64 65 912 913 913 913
753 753 754 755 722 723 913 913 914 64 64 64 98 66 720 98 66 98 98 98 98 66 98 944 912 913 913
721 721 722 723 754 755 722 723 913 882 66 98 66 98 98 66 98 880 881 882 98 98 98 65 944 912 913
753 753 754 755 753 753 754 755 818 818 882 98 816 817 98 880 881 913 913 914 98 66 66 98 65 944 912
721 722 723 753 913 913 913 913 945 945 946 98 848 849 98 912 913 913 945 946 98 98 932 720 66 65 912
753 754 755 913 913 945 945 946 64 64 64 98 64 64 98 944 945 946 64 266 274 275 267 98 98 98 944
913 913 913 945 946 868 64 65 66 98 98 98 66 98 98 64 64 64 98 302 401 401 303 66 720 98 65
913 913 914 64 65 98 98 44 45 66 98 880 881 882 98 66 98 720 98 302 401 401 303 98 98 98 66
913 913 914 66 70 79 79 71 98 880 881 913 913 913 882 98 66 98 98 302 433 433 303 98 880 881 881
